# syntax: "A\tB" or "A\tB\tC". C=々: duplicate; C=A: absorbed; C=×: missing.
𠃊	乚
𠈧	𠈿
㑢	𠉨
𠌀	𠊻	々
𣍓	𠕰
兇	凶	兇
𠛬	刑
𠡁	𠡅
𠦌	卌
𠧎	𠧉	々
卻	却	卻
𠬍	㕙
臺	台	臺
㕥	叽
吁	𠮱	×
呐	吶
噓	嘘
𡉏	圮
墑	墒	墑
墮	墯	墮
𡕔	夃
𡢌	𡡨
嬎	嬔
𡧽	𡧬
𡵏	𡴁
𡺛	𡸓
𠇰	𢁭
冪	幂	×
𢎟	𢎛
𢎰	㢪
悶	𢛀
懡	𢣗
於	扵	×
𢬽	𢮆
𢮨	𢮛
𢳛	摣
搟	擀
攍	𢺆
𡕕	𢻯	𡕕
𢻍	𢼅
	𢼙	×
敚	敓
𢼶	𣁊
𢾡	𣁗
𢿜	𣁜
𢿻	𣁣
旣	既	旣
𣈶	暅
暨	曁
脼	𣍷
朵	朶	朵
呆	𣏁	呆
柿	杮
𣐥	某
棲	栖	棲
𣗀	𣒉
𣓧	𣕏
𨍛	𣫹	𨍛
𣬃	𣬇
洛	洜
𣺬	㵁
𤄸	𤄼
焧	𤊘	×
㶤	𤊝	×
熙	煕
	𤌃	×
𤍞	燁
𤩡	𤩋
𠇚	𤰒
痺	𤷒
𤸭	㿅
𥁋	盇
瞇	眯	瞇
𥅰	𥅤
𥟟	𥟙
稽	𥠻
𥤚	𥤛
穴	𥤢
𥩑	𥩎
𥬰	笧
𥲓	𥵭
𥶢	䉭
𥾻	𥾟
絕	絶
	𦁟	×
纏	纒	纏
𦉽	𦉺
𦒊	𦑷
	䏼	×
𣎅	𦝲
𣎟	𦠅
𣎛	𦠈
致	𦤶
𦦭	𦦦
𠁥	𦫳
茍	苟	茍
蘋	苹	×
𦰨	𦮆
𠌓	䓥
𨔴	𦴚
𧗆	䕄	𧗆
𤗽	䕈
𨗲	薖
𦾕	䕎
夔	𧃰
𡖂	夔
𥃓	𧈚
蟰	𧑛
𧟶	𧟳
豟	䝈	豟
𧻞	趓
𨏇	𨎯
適	适	×
𨖈	䢣
邎	𨙂
邔	𨙬
𨡻	䤇
鑙	𨮺
閒	間	×
巂	雟
𩅉	𩅧
䨶	𩆹
頽	頹
顔	顏
𩕇	𩔣
騩	𩥢	×
	𩥥	×
𩻼	𩼍
䳹	𪄺
䴳	𪌡	䴳
𡤞	䶯
	𪛖	×