BÀI SỐ 4
Ngữ pháp
1. Cách đặt câu hỏi với "đã...chưa"
2. Cách đặt câu hỏi toàn bộ với "có phải ... không"
3. Cách gọi các ngày trong một tuần.
4. Số thứ tự.
5. Các đại từ đề hỏi "mấy, bao nhiêu"
6. Các ngữ khí từ "nhỉ, đấy"
7. Cách gọi giờ

BÀI TẬP ĐỌC
MỘT TẬP THỂ ĐẦM ẤM
Trường chúng tôi có nhiều ký túc xá. Tôi ở
ký túc xá số ba. Ký túc xá chúng tôi là một ngôi
nhà bốn tầng, vừa cao vừa rộng. Tôi ở tầng thứ
hai, phòng số hai trăm mười tám.

Phòng ngủ của chúng tôi bao giờ cũng sạch
sẽ và ngăn nắp. Giường, bàn, ghế và giá sách đều
lau chùi sạch sẽ. Chăn đệm, gối màn, quần áo, 
sách báo đều xếp đặt ngăn nắp.

Cường, Minh, Chí và tôi ở chung một phòng.
Ba anh ấy đều là bạn cùng lớp của tôi. Trước
kia chúng tôi mỗi người ở một nơi, không quen nhau.
Bây giờ chúng tôi ở chung một phòng, học chung
một lớp. Chúng tôi săn sóc nhau, giúp đỡ nhau,
thân yêu nhau như anh em một nhà. Các thầy giáo
và cô giáo đều khen bốn người chúng tôi là một
tập thể đầm ấm.

Chào anh.
Chào thầy, mời thầy ngồi chơi.
Anh đang làm gì đấy?
Tôi đang xem báo.
Đây là phòng ngủ của anh có phải không?
Vâng, tôi và Cường, Minh, Chí bốn người cùng ở một phòng.
Phòng ngủ của các anh rộng rãi nhỉ?
Vâng, bốn người ở chúng một phòng rộng thế này đã khá lắm rồi.
Có phải anh Hồng ở phòng số 219 không?
Không, anh ấy ở phòng số 217.
Anh ấy đã về chưa?
Chưa, anh ấy chưa về ạ. Anh ấy đi thư viện rồi.
Các anh đã ăn cơm chưa?
Thưa thầy, chúng tôi ăn rồi ạ.
Hàng ngày các anh mấy giờ ăn cơm?
Hàng ngày chúng tôi sáu giờ rưỡi ăn sáng, mười hai giờ kém mười lăm (phút) ăn cơm trưa, đúng sáu giờ ăn cơm chiều.
Các anh mấy giờ dậy và mấy giờ đi ngủ?
Chúng tôi năm giờ rưỡi dậy, mười một giờ đêm đi ngủ.
Các anh làm việc phải có giờ giấc, không nên làm khuya quá.
Mỗi tuần các anh lên lớp bao nhiêu tiết (tiếng đồng hồ)?
Mỗi tuần chúng tôi lên lớp hai mươi hai tiết.
Chủ nhật các anh có nghỉ không?
Có nghỉ, thầy ạ.
Sáng sớm các anh có tập thể dục không?
Thưa thầy, sáng sớm chúng tôi thường chạy dai sức ạ.
Như thế tốt đấy, các anh cần luôn luôn rèn luyện thân thể mới được.
Vâng, xin cảm ơn thầy. 

Từ mới
tập thể: 集体
đầm ấm: 温暖
số ba: 三号
ngôi: 座,幢,栋
nhà: 房子
bốn: 四
tầng: 层
vừa...vừa...: 又...又...
cao: 高
rộng: 宽敞
thứ hai: 第二
phòng: 房
hai: 二
trăm: 百
mười: 十
bao giờ: 任何时候
cũng: 都
ngăn nắp: 整洁,整齐
giường: 床
lau chùi: 擦拭
chăn: 被子
đệm: 褥子
gối: 枕头
màn: 帐子
quần áo: 衣服
sách báo: 书报
xếp đặt: 放置,摆设
Chí: 志
chung: 共同
bạn: 朋友
cùng: 同一,共同,一起
trước kia: 以前
nơi: 地方
quen: 认识
nhau: 互相
săn sóc: 照顾
giúp đỡ: 帮助
thân yêu: 亲近,亲爱
như: 如
em: 弟/妹
cô giáo: 女老师
khên: 表扬,称赞
mời: 请
đấy: 语气词
...có phải không?: ...是吗?
nhỉ: 语气词.是不是啊?
khá: 不错
có phải...không?: 是...吗? 是不是...?
chưa: 尚未,没有
ăn: 吃
cơm: 饭
hàng ngày: 每天
mấy: 几
sáu: 六
rưỡi: 半
ăn sáng: 吃早饭
kém: 差
mười lăm: 十五
phút: 分钟
trưa: 中午
đúng: 正好
chiều: 下午
dậy: 起床
ngủ: 睡觉
năm: 五
đêm: 夜晚
việc: 事
phải: 必须
giờ giấc: 作息时间
khuya: 深夜
quá: 过分
bao nhiêu: 多少
tiếng đồng hồ: 小时
chủ nhật: 星期日
nghỉ: 休息
sáng sớm: 清晨
thường: 经常
chạy dai sức: 长跑
như thế: 如此
cần: 需要
luôn luôn: 常常,经常不断
rèn luyện: 锻炼
thân thể: 身体
mới: 才
đước: 行
cảm ơn: 感恩

Những câu thường dùng trong lớp
-Trong hai tiết này chúng ta tập nghe theo máy ghi âm.
-Bây giờ tôi mở máy, chúng ta bắt đầu nghe.
-Thưa thầy, đoạn này đọc nhanh quá, chúng tôi nghe không rõ.
-Thế chúng ta nghe lại một lần nữa.
-Anh Phú nói lại nội dung trong bài ghi âm.
-Chị Phượng bổ sung thêm.
-Chuông rồi, chúng ta đến đây kết thúc.

Từ mới
trong: 在……中
nghe: 听
máy ghi âm: 录音机
mở: 打开
máy: 机器
bắt đầu: 开始，起头
đoạn: 段
nhanh: 快
rõ: 清楚
thế: 那样，那么
lại: 再、又、重新
lần: 次
nữa: 再一次
Phú: 富
nói: 讲、说
nội dung: 内容
ghi âm: 记音，录音
Phượng: 凤
bổ sung: 补充
thêm: 添
chuông: 铃、铃响
kết thúc: 结束